[[0,0,0,0,0,0,0,0,0],
 [2,0,8,1,0,0,7,0,0],
 [5,0,1,4,2,0,6,0,0],
 [8,1,4,0,3,0,2,0,7],
 [0,6,0,2,0,5,0,1,9],
 [0,5,0,7,4,0,0,6,3],
 [0,0,0,0,7,4,5,8,1],
 [1,8,5,9,0,2,0,0,0],
 [4,0,3,0,0,8,0,2,6]]