[[0,6,0,0,1,9,8,7,2],
[9,0,7,2,8,5,1,4,6],
[8,1,2,7,4,0,9,5,0],
[7,5,6,4,9,0,2,3,0],
[3,9,4,0,2,1,7,8,5],
[2,8,1,5,0,3,4,6,9],
[1,4,0,9,0,7,5,2,8],
[5,0,8,0,3,4,0,9,7],
[0,7,9,0,5,2,0,1,4]]